36 36
__##############EEEE#########_______
###                      B  ########
#                                  #
#                                  #
#     m       XXXXXXXX             #
#                 XXX              #
#                                  #
#                      M           #
######X                            #
______####XXXX                     #
######XXXXXX                       #
#                                  #
#                        O         #
#                                  #
#  O         XXXX                  #
#          XXXX                 X###
#     M                     X####___
#                       XXXX#_______
#        m                XXX####___
#                           X##_____
#XXX                        #_______
#                        XXXX####___
#           XXXX              XXX###
#          XXXXXXXXX               #
#           XXXXXXX                #
#                         X        #
##X                    XXXXXX      #
__#          O           XXXX      #
___#                               #
__#                              XX#
__#         X                  XXXX#
__#        XXX                    X#
_#    P     X                p     #
#                                  #
#                 X#################
###################_________________