36 36
__##############EEEE#########_______
###                      B  ########
#                                  #
#                                  #
#     m                            #
#                                  #
#                                  #
#                      M           #
#######                            #
______########                     #
############                       #
#                                  #
#                        O         #
#                                  #
#  O         ####                  #
#          ####                 ####
#                           #####___
#                       #####_______
#        m                #######___
#                           ###_____
#                           #_______
#                        ########___
#           ####              ######
#          #########               #
#           #######                #
#                         #        #
__#                    ######      #
__#          O           ####      #
___#                               #
__#        P                       #
__#                                #
__#                  p             #
_#                                 #
#                                  #
#                 ##################
###################_________________